160,160,160,160,160,160,160,160,160,160,160,160,160,160,160,160
160,160,160,160,160,160,160,160,160,160,160,160,160,160,160,160
62,61,63,62,62,62,62,62,62,62,63,62,63,62,62,62
3,4,34,0,0,34,4,1,0,0,0,0,33,8,0,10
8,1,10,0,0,4,0,0,4,0,0,10,0,0,4,0
0,8,1,0,0,99,100,100,100,100,101,0,10,10,0,0
0,0,0,0,0,115,13,12,13,12,117,0,0,1,4,0
4,10,10,0,0,102,13,12,12,14,102,0,8,0,10,0
0,0,4,6,0,118,12,13,12,12,117,0,0,10,0,0
0,5,1,1,0,131,132,13,13,132,133,0,0,0,0,0
0,0,0,10,0,0,76,14,15,76,0,0,30,31,29,28
0,1,0,0,0,0,34,0,29,33,0,30,12,13,12,12
10,0,0,0,10,0,0,0,0,0,0,12,15,0,14,12
0,0,0,0,0,0,10,1,0,0,0,29,28,29,30,13
0,1,0,1,0,0,0,0,6,0,0,29,14,12,13,13
