160,160,160,160,160,160,160,160,160,160,160,160,160,160,160,160
160,160,160,160,160,160,160,160,160,160,160,160,160,160,160,160
131,101,28,0,30,31,43,131,101,28,14,29,15,12,15,131
14,131,101,28,14,12,31,0,131,101,0,0,29,13,0,0
28,14,131,101,0,14,28,0,0,131,101,0,0,14,31,0
43,42,0,131,101,0,0,0,30,31,131,101,0,43,75,42
0,27,0,0,131,101,29,30,12,12,31,131,101,0,33,29
28,0,29,28,0,131,101,0,14,12,12,0,131,101,0,14
101,0,0,14,31,0,131,101,0,14,15,28,0,131,101,0
131,101,0,0,0,0,0,131,101,0,0,29,0,0,131,101
14,131,101,0,0,29,12,0,131,101,0,14,12,0,0,131
0,29,131,101,0,12,15,28,0,131,101,0,13,12,0,0
15,28,29,131,101,0,14,13,31,0,131,101,28,14,12,0
42,29,12,31,131,101,0,14,12,15,43,131,101,29,15,29
101,0,14,12,14,131,101,0,29,0,28,0,131,101,0,28
