58,60,60,60,60,60,60,60,60,60,60,60,60,60,60,60
59,2,3,4,5,6,7,8,0,0,14,13,15,13,13,58
58,3,0,76,0,0,2,3,4,5,0,29,28,0,14,59
58,0,76,0,76,0,0,0,0,0,30,13,13,31,30,58
58,0,0,76,0,6,7,8,0,10,49,50,49,49,50,49
59,6,7,8,0,0,0,0,0,0,0,33,33,33,6,58
49,50,50,49,49,50,0,0,0,3,4,5,6,7,8,58
58,33,0,0,6,95,8,0,0,0,0,0,0,0,0,58
58,0,2,3,4,95,6,0,0,0,5,6,7,8,0,59
59,0,0,6,7,95,37,0,0,0,49,50,49,49,50,50
58,6,7,8,0,95,0,8,10,0,115,10,7,8,1,58
50,50,50,49,50,50,0,8,8,0,102,0,0,0,3,59
59,33,2,3,4,34,6,7,8,38,77,37,7,60,0,58
58,0,0,6,7,8,0,0,0,0,115,0,0,0,9,58
60,60,60,60,60,60,60,60,60,60,60,60,60,60,60,60
