50,49,49,50,49,49,50,49,50,49,50,50,49,50,49,50
0,34,0,0,6,0,34,0,7,0,0,8,0,0,34,0
0,2,233,234,235,0,7,0,0,0,0,0,0,10,0,8
0,0,176,177,178,179,180,179,196,176,177,178,198,199,223,0
8,0,192,193,194,195,10,195,228,228,7,229,229,228,204,8
8,0,208,209,210,211,212,211,197,213,214,215,216,232,0,0
0,8,224,225,7,226,180,227,224,224,0,227,230,231,0,0
0,5,0,0,0,217,218,219,220,221,222,0,0,0,0,0
0,0,6,0,0,9,0,0,9,0,0,0,0,9,6,0
0,0,0,0,0,6,6,0,0,0,0,0,0,0,0,0
0,0,4,0,200,201,202,203,204,205,206,207,0,0,0,8
0,0,0,0,0,0,6,0,0,0,0,6,0,0,0,0
0,6,0,0,0,0,236,237,238,239,0,0,0,0,6,0
7,36,0,0,10,35,0,0,0,0,0,0,8,0,0,36
55,55,55,55,55,55,55,55,55,55,55,55,55,55,55,55
