160,160,160,160,160,160,160,160,160,160,160,160,160,160,160,160
160,160,160,160,160,160,160,160,160,160,160,160,160,160,160,160
50,50,50,50,50,50,50,50,50,50,50,50,50,50,50,50
10,1,1,1,1,1,1,6,0,0,0,5,1,1,1,1
1,1,6,0,0,0,0,0,0,0,8,1,1,1,1,1
1,1,1,1,7,95,78,78,78,79,0,8,1,1,1,1
1,1,1,1,1,95,0,75,0,79,7,0,0,0,8,1
1,1,1,1,1,95,78,78,78,79,8,1,1,1,1,1
1,2,0,0,0,0,0,0,0,0,0,0,0,0,0,1
1,95,62,62,62,79,5,1,1,7,95,62,62,62,79,1
1,95,0,71,0,79,1,1,1,7,95,0,71,0,79,1
1,95,61,61,61,79,3,1,1,1,95,62,62,62,79,1
6,0,0,0,0,0,0,4,1,10,0,0,0,0,0,1
7,5,1,7,9,7,0,5,1,1,5,1,6,5,1,1
1,1,1,1,1,1,0,0,0,8,1,6,0,0,8,1
