160,160,160,160,160,160,160,160,160,160,160,160,160,160,160,160
160,160,160,160,160,160,160,160,160,160,160,160,160,160,160,160
10,10,0,0,10,10,0,59,58,0,9,0,0,0,7,10
10,0,0,0,0,10,0,58,59,0,0,8,8,8,1,6
0,0,0,35,0,0,0,58,58,0,9,0,0,0,6,0
62,62,62,62,37,0,0,60,60,0,0,38,63,62,62,62
0,33,8,34,0,0,0,0,0,0,0,0,34,0,0,0
10,0,0,0,8,10,0,43,26,8,0,0,2,0,6,6
0,0,0,8,8,1,7,26,43,8,0,0,8,1,0,0
0,10,8,0,0,3,6,7,0,0,0,0,6,6,6,0
0,0,0,0,0,0,0,0,0,10,10,0,0,0,0,0
61,62,61,61,10,0,0,58,58,0,0,38,63,62,61,62
33,0,0,34,0,0,0,59,58,0,0,0,8,0,0,34
0,0,0,9,0,9,8,59,58,7,0,75,8,8,0,0
8,10,0,0,0,0,0,59,59,0,0,34,0,7,0,7
